timesteps,trial,premort_total,postmort_total,hatch_interval,adult_number,total_mosquito_number,larvae_number,mort_time,mort_percent,tot,diff,pop_persist,treatment
1000,25,27427,27337,asynch,20,417,385,control,0,405,-90,1,1
1000,26,26778,27440,asynch,20,387,357,control,0,377,662,1,1
1000,27,27534,27621,asynch,15,401,379,control,0,394,87,1,1
1000,28,26726,28128,asynch,16,395,370,control,0,386,1402,1,1
1000,29,27419,27075,asynch,23,414,379,control,0,402,-344,1,1
1000,30,27128,28035,asynch,23,438,404,control,0,427,907,1,1
1000,31,27351,26867,asynch,20,412,380,control,0,400,-484,1,1
1000,32,27183,28461,asynch,18,389,363,control,0,381,1278,1,1
1000,33,28457,27743,asynch,17,434,409,control,0,426,-714,1,1
1000,34,27461,27476,asynch,19,428,397,control,0,416,15,1,1
1000,35,27332,28482,asynch,20,428,399,control,0,419,1150,1,1
1000,36,27304,28938,asynch,18,424,398,control,0,416,1634,1,1
1000,37,27906,27080,asynch,17,457,430,control,0,447,-826,1,1
1000,38,27530,26831,asynch,15,403,381,control,0,396,-699,1,1
1000,39,27509,27976,asynch,20,410,379,control,0,399,467,1,1
1000,40,26842,27238,asynch,15,438,416,control,0,431,396,1,1
1000,41,27297,28301,asynch,20,416,387,control,0,407,1004,1,1
1000,42,27374,27507,asynch,22,430,396,control,0,418,133,1,1
1000,43,27947,27562,asynch,15,420,400,control,0,415,-385,1,1
1000,44,27836,28012,asynch,20,441,412,control,0,432,176,1,1
1000,45,28289,27221,asynch,23,382,345,control,0,368,-1068,1,1
1000,46,28156,27785,asynch,24,415,382,control,0,406,-371,1,1
1000,47,27191,28423,asynch,14,422,401,control,0,415,1232,1,1
1000,48,27221,27120,asynch,13,441,420,control,0,433,-101,1,1
1000,49,27174,27332,asynch,17,400,369,control,0,386,158,1,1
1000,400,26960,25744,asynch,23,425,387,early,10,410,-1216,1,2
1000,401,27311,27464,asynch,22,334,300,early,10,322,153,1,2
1000,402,27170,27191,asynch,18,382,354,early,10,372,21,1,2
1000,403,27655,26716,asynch,27,434,391,early,10,418,-939,1,2
1000,404,27585,26740,asynch,22,370,335,early,10,357,-845,1,2
1000,405,27528,26161,asynch,17,392,366,early,10,383,-1367,1,2
1000,406,28245,27069,asynch,24,376,339,early,10,363,-1176,1,2
1000,407,26831,26246,asynch,15,356,332,early,10,347,-585,1,2
1000,408,27915,26383,asynch,19,402,371,early,10,390,-1532,1,2
1000,409,27826,26939,asynch,11,390,375,early,10,386,-887,1,2
1000,410,27242,26486,asynch,14,392,372,early,10,386,-756,1,2
1000,411,27972,26286,asynch,23,401,364,early,10,387,-1686,1,2
1000,412,27483,26877,asynch,19,409,378,early,10,397,-606,1,2
1000,413,28132,26430,asynch,23,386,351,early,10,374,-1702,1,2
1000,414,27817,27371,asynch,14,385,360,early,10,374,-446,1,2
1000,415,28082,26670,asynch,15,400,379,early,10,394,-1412,1,2
1000,416,27941,27846,asynch,17,382,359,early,10,376,-95,1,2
1000,417,27168,26395,asynch,20,416,382,early,10,402,-773,1,2
1000,418,28443,26943,asynch,15,428,407,early,10,422,-1500,1,2
1000,419,27435,27137,asynch,19,400,370,early,10,389,-298,1,2
1000,420,26954,27199,asynch,28,448,405,early,10,433,245,1,2
1000,421,26199,26652,asynch,14,399,377,early,10,391,453,1,2
1000,422,27928,25971,asynch,14,413,393,early,10,407,-1957,1,2
1000,423,27809,26769,asynch,17,422,396,early,10,413,-1040,1,2
1000,424,27504,27504,asynch,14,377,353,early,10,367,0,1,2
1000,425,28658,27100,asynch,21,382,350,early,25,371,-1558,1,3
1000,426,26416,25143,asynch,14,339,317,early,25,331,-1273,1,3
1000,427,26931,25505,asynch,21,352,317,early,25,338,-1426,1,3
1000,428,28124,25966,asynch,18,355,328,early,25,346,-2158,1,3
1000,429,27562,25371,asynch,24,389,355,early,25,379,-2191,1,3
1000,430,27722,26066,asynch,23,368,329,early,25,352,-1656,1,3
1000,431,27463,26184,asynch,27,356,312,early,25,339,-1279,1,3
1000,432,27428,24848,asynch,26,332,288,early,25,314,-2580,1,3
1000,433,26374,25647,asynch,17,354,327,early,25,344,-727,1,3
1000,434,27667,25521,asynch,22,372,340,early,25,362,-2146,1,3
1000,435,28443,26266,asynch,25,379,339,early,25,364,-2177,1,3
1000,436,27837,25790,asynch,21,376,342,early,25,363,-2047,1,3
1000,437,27845,25239,asynch,23,336,300,early,25,323,-2606,1,3
1000,438,27021,26590,asynch,23,380,344,early,25,367,-431,1,3
1000,439,28115,25611,asynch,18,363,335,early,25,353,-2504,1,3
1000,440,28901,26607,asynch,20,361,329,early,25,349,-2294,1,3
1000,441,27590,25039,asynch,18,402,373,early,25,391,-2551,1,3
1000,442,27539,25840,asynch,28,382,336,early,25,364,-1699,1,3
1000,443,27571,25086,asynch,16,350,326,early,25,342,-2485,1,3
1000,444,26858,26055,asynch,30,360,315,early,25,345,-803,1,3
1000,445,26899,25035,asynch,24,364,330,early,25,354,-1864,1,3
1000,446,27402,25399,asynch,24,380,344,early,25,368,-2003,1,3
1000,447,27515,25888,asynch,22,374,339,early,25,361,-1627,1,3
1000,448,26708,26944,asynch,26,404,360,early,25,386,236,1,3
1000,449,27625,24850,asynch,22,374,341,early,25,363,-2775,1,3
1000,450,27459,22717,asynch,28,299,257,early,50,285,-4742,1,4
1000,451,27640,23210,asynch,22,269,237,early,50,259,-4430,1,4
1000,452,26539,23204,asynch,28,306,263,early,50,291,-3335,1,4
1000,453,26205,22356,asynch,35,304,246,early,50,281,-3849,1,4
1000,454,27571,23771,asynch,37,313,251,early,50,288,-3800,1,4
1000,455,27494,22970,asynch,24,321,284,early,50,308,-4524,1,4
1000,456,27722,23620,asynch,27,311,268,early,50,295,-4102,1,4
1000,457,27168,23857,asynch,33,311,260,early,50,293,-3311,1,4
1000,458,28118,23062,asynch,24,311,273,early,50,297,-5056,1,4
1000,459,26602,23334,asynch,32,297,245,early,50,277,-3268,1,4
1000,460,27159,23699,asynch,22,272,233,early,50,255,-3460,1,4
1000,461,27204,21902,asynch,26,315,269,early,50,295,-5302,1,4
1000,462,27034,22545,asynch,28,267,225,early,50,253,-4489,1,4
1000,463,26088,23452,asynch,26,307,265,early,50,291,-2636,1,4
1000,464,28058,23647,asynch,26,268,227,early,50,253,-4411,1,4
1000,465,28204,22802,asynch,32,301,246,early,50,278,-5402,1,4
1000,466,27902,21978,asynch,20,297,266,early,50,286,-5924,1,4
1000,467,27399,22386,asynch,25,263,225,early,50,250,-5013,1,4
1000,468,27721,22956,asynch,21,285,254,early,50,275,-4765,1,4
1000,469,26990,23425,asynch,30,297,249,early,50,279,-3565,1,4
1000,470,26795,23284,asynch,26,308,266,early,50,292,-3511,1,4
1000,471,27359,22681,asynch,24,315,276,early,50,300,-4678,1,4
1000,472,26744,22474,asynch,26,317,274,early,50,300,-4270,1,4
1000,473,26739,23361,asynch,33,302,252,early,50,285,-3378,1,4
1000,474,27363,22933,asynch,32,346,298,early,50,330,-4430,1,4
748,486,27608,1029,asynch,0,0,0,early,75,0,-26579,0,5
815,487,27884,1176,asynch,0,0,0,early,75,0,-26708,0,5
831,485,27607,1470,asynch,0,0,0,early,75,0,-26137,0,5
831,494,26799,2332,asynch,0,0,0,early,75,0,-24467,0,5
850,477,28651,1029,asynch,0,0,0,early,75,0,-27622,0,5
874,475,26442,1092,asynch,0,0,0,early,75,0,-25350,0,5
889,491,26421,3024,asynch,0,0,0,early,75,0,-23397,0,5
896,499,26859,2122,asynch,0,0,0,early,75,0,-24737,0,5
902,478,26087,1743,asynch,0,0,0,early,75,0,-24344,0,5
921,489,27088,819,asynch,0,0,0,early,75,0,-26269,0,5
931,495,27275,1575,asynch,0,0,0,early,75,0,-25700,0,5
940,484,27019,2731,asynch,0,0,0,early,75,0,-24288,0,5
955,490,27582,3424,asynch,0,0,0,early,75,0,-24158,0,5
975,480,27077,966,asynch,0,0,0,early,75,0,-26111,0,5
1000,476,27002,2142,asynch,2,7,3,early,75,5,-24860,1,5
1000,479,28262,3214,asynch,2,8,4,early,75,6,-25048,1,5
1000,481,27613,2312,asynch,0,1,1,early,75,1,-25301,1,5
1000,482,27591,2394,asynch,0,3,3,early,75,3,-25197,1,5
1000,483,27464,2521,asynch,0,8,8,early,75,8,-24943,1,5
1000,488,26679,3276,asynch,0,9,9,early,75,9,-23403,1,5
1000,492,27698,2877,asynch,0,2,2,early,75,2,-24821,1,5
1000,493,27572,2310,asynch,0,2,2,early,75,2,-25262,1,5
1000,496,26990,3655,asynch,2,6,3,early,75,5,-23335,1,5
1000,497,27296,2205,asynch,0,1,1,early,75,1,-25091,1,5
1000,498,27401,1702,asynch,2,9,6,early,75,8,-25699,1,5
568,523,26869,0,asynch,0,0,0,early,90,0,-26869,0,6
575,501,26622,0,asynch,0,0,0,early,90,0,-26622,0,6
581,511,27574,0,asynch,0,0,0,early,90,0,-27574,0,6
587,510,26056,0,asynch,0,0,0,early,90,0,-26056,0,6
590,517,27306,0,asynch,0,0,0,early,90,0,-27306,0,6
592,505,26043,0,asynch,0,0,0,early,90,0,-26043,0,6
592,508,27557,0,asynch,0,0,0,early,90,0,-27557,0,6
592,512,27451,0,asynch,0,0,0,early,90,0,-27451,0,6
592,519,26598,0,asynch,0,0,0,early,90,0,-26598,0,6
592,521,27387,0,asynch,0,0,0,early,90,0,-27387,0,6
592,524,27113,0,asynch,0,0,0,early,90,0,-27113,0,6
595,514,26946,0,asynch,0,0,0,early,90,0,-26946,0,6
595,518,26092,0,asynch,0,0,0,early,90,0,-26092,0,6
597,520,27398,0,asynch,0,0,0,early,90,0,-27398,0,6
598,500,27830,0,asynch,0,0,0,early,90,0,-27830,0,6
600,502,25836,0,asynch,0,0,0,early,90,0,-25836,0,6
602,503,27087,0,asynch,0,0,0,early,90,0,-27087,0,6
603,516,26234,0,asynch,0,0,0,early,90,0,-26234,0,6
604,509,27449,0,asynch,0,0,0,early,90,0,-27449,0,6
622,506,27995,0,asynch,0,0,0,early,90,0,-27995,0,6
627,504,27466,0,asynch,0,0,0,early,90,0,-27466,0,6
632,522,27483,0,asynch,0,0,0,early,90,0,-27483,0,6
635,507,27062,0,asynch,0,0,0,early,90,0,-27062,0,6
655,515,26534,0,asynch,0,0,0,early,90,0,-26534,0,6
662,513,27863,21,asynch,0,0,0,early,90,0,-27842,0,6
1000,75,26930,27743,asynch,14,417,396,late,10,410,813,1,7
1000,76,26603,27379,asynch,22,430,397,late,10,419,776,1,7
1000,77,26695,26704,asynch,24,420,380,late,10,404,9,1,7
1000,78,27333,26991,asynch,15,400,380,late,10,395,-342,1,7
1000,79,27804,27416,asynch,20,398,366,late,10,386,-388,1,7
1000,80,27928,27848,asynch,18,393,368,late,10,386,-80,1,7
1000,81,27826,28301,asynch,16,374,348,late,10,364,475,1,7
1000,82,27939,27248,asynch,15,398,372,late,10,387,-691,1,7
1000,83,26886,27466,asynch,16,392,369,late,10,385,580,1,7
1000,84,28840,27948,asynch,12,404,386,late,10,398,-892,1,7
1000,85,28348,28287,asynch,24,424,390,late,10,414,-61,1,7
1000,86,27415,26825,asynch,28,395,350,late,10,378,-590,1,7
1000,87,27424,27772,asynch,16,386,363,late,10,379,348,1,7
1000,88,28213,26465,asynch,17,384,356,late,10,373,-1748,1,7
1000,89,26899,27939,asynch,14,412,393,late,10,407,1040,1,7
1000,90,27462,27543,asynch,21,389,352,late,10,373,81,1,7
1000,91,26684,27959,asynch,17,361,334,late,10,351,1275,1,7
1000,92,27859,26835,asynch,22,406,369,late,10,391,-1024,1,7
1000,93,26978,27614,asynch,18,393,363,late,10,381,636,1,7
1000,94,27356,27258,asynch,23,407,373,late,10,396,-98,1,7
1000,95,27834,27762,asynch,12,390,369,late,10,381,-72,1,7
1000,96,27144,28020,asynch,18,386,354,late,10,372,876,1,7
1000,97,28539,27786,asynch,22,398,364,late,10,386,-753,1,7
1000,98,27509,26300,asynch,24,411,376,late,10,400,-1209,1,7
1000,99,26551,27237,asynch,12,322,301,late,10,313,686,1,7
1000,100,27888,26589,asynch,19,371,346,late,25,365,-1299,1,8
1000,101,27632,27603,asynch,16,364,338,late,25,354,-29,1,8
1000,102,28349,27093,asynch,20,375,344,late,25,364,-1256,1,8
1000,103,28198,26760,asynch,16,334,311,late,25,327,-1438,1,8
1000,104,27305,28372,asynch,14,381,362,late,25,376,1067,1,8
1000,105,27921,27110,asynch,24,389,353,late,25,377,-811,1,8
1000,106,27272,25997,asynch,10,388,372,late,25,382,-1275,1,8
1000,107,28206,27475,asynch,17,373,347,late,25,364,-731,1,8
1000,108,28088,27847,asynch,22,383,349,late,25,371,-241,1,8
1000,109,26882,26799,asynch,17,364,336,late,25,353,-83,1,8
1000,110,28297,28249,asynch,19,381,353,late,25,372,-48,1,8
1000,111,26565,26616,asynch,22,404,368,late,25,390,51,1,8
1000,112,28770,26555,asynch,22,382,346,late,25,368,-2215,1,8
1000,113,27838,26005,asynch,21,373,338,late,25,359,-1833,1,8
1000,114,27417,26411,asynch,17,373,349,late,25,366,-1006,1,8
1000,115,27173,28538,asynch,15,387,364,late,25,379,1365,1,8
1000,116,27018,27302,asynch,25,395,357,late,25,382,284,1,8
1000,117,26762,27140,asynch,19,362,331,late,25,350,378,1,8
1000,118,27064,27280,asynch,19,391,359,late,25,378,216,1,8
1000,119,28143,27039,asynch,26,391,348,late,25,374,-1104,1,8
1000,120,27924,26397,asynch,23,408,373,late,25,396,-1527,1,8
1000,121,28621,27310,asynch,16,377,351,late,25,367,-1311,1,8
1000,122,27491,26809,asynch,15,408,386,late,25,401,-682,1,8
1000,123,28019,26357,asynch,16,377,348,late,25,364,-1662,1,8
1000,124,27042,27756,asynch,19,382,352,late,25,371,714,1,8
1000,125,26894,27085,asynch,20,342,310,late,50,330,191,1,9
1000,126,27258,26655,asynch,18,307,276,late,50,294,-603,1,9
1000,127,25944,26627,asynch,17,322,293,late,50,310,683,1,9
1000,128,28073,27035,asynch,17,290,262,late,50,279,-1038,1,9
1000,129,27954,27342,asynch,15,327,303,late,50,318,-612,1,9
1000,130,26987,27712,asynch,17,335,307,late,50,324,725,1,9
1000,131,27355,28011,asynch,18,314,284,late,50,302,656,1,9
1000,132,28540,26954,asynch,13,292,271,late,50,284,-1586,1,9
1000,133,27543,27315,asynch,14,249,227,late,50,241,-228,1,9
1000,134,27075,27291,asynch,15,338,317,late,50,332,216,1,9
1000,135,28486,27586,asynch,17,303,273,late,50,290,-900,1,9
1000,136,28190,27110,asynch,12,291,270,late,50,282,-1080,1,9
1000,137,27055,26509,asynch,16,352,322,late,50,338,-546,1,9
1000,138,26811,26809,asynch,17,288,263,late,50,280,-2,1,9
1000,139,28003,27281,asynch,13,294,272,late,50,285,-722,1,9
1000,140,27690,26469,asynch,14,348,322,late,50,336,-1221,1,9
1000,141,28425,26796,asynch,18,293,264,late,50,282,-1629,1,9
1000,142,26804,26721,asynch,13,316,296,late,50,309,-83,1,9
1000,143,28044,26669,asynch,21,316,284,late,50,305,-1375,1,9
1000,144,28015,27342,asynch,11,226,207,late,50,218,-673,1,9
1000,145,26683,26841,asynch,18,321,290,late,50,308,158,1,9
1000,146,26654,27192,asynch,14,308,286,late,50,300,538,1,9
1000,147,27741,27453,asynch,21,378,342,late,50,363,-288,1,9
1000,148,27476,27116,asynch,23,350,315,late,50,338,-360,1,9
1000,149,27745,27071,asynch,12,265,243,late,50,255,-674,1,9
1000,150,28216,24425,asynch,17,198,169,late,75,186,-3791,1,10
1000,151,26568,26029,asynch,6,235,224,late,75,230,-539,1,10
1000,152,26611,26107,asynch,5,155,145,late,75,150,-504,1,10
1000,153,26551,26616,asynch,13,228,206,late,75,219,65,1,10
1000,154,28101,25364,asynch,15,243,218,late,75,233,-2737,1,10
1000,155,28069,24799,asynch,5,155,146,late,75,151,-3270,1,10
1000,156,27518,24206,asynch,11,179,160,late,75,171,-3312,1,10
1000,157,28023,25151,asynch,14,211,188,late,75,202,-2872,1,10
1000,158,27093,26058,asynch,13,209,188,late,75,201,-1035,1,10
1000,159,27573,26676,asynch,10,217,201,late,75,211,-897,1,10
1000,160,27311,24856,asynch,19,243,210,late,75,229,-2455,1,10
1000,161,27530,25921,asynch,10,198,181,late,75,191,-1609,1,10
1000,162,27430,25295,asynch,10,201,184,late,75,194,-2135,1,10
1000,163,27010,27021,asynch,11,189,171,late,75,182,11,1,10
1000,164,26481,25410,asynch,12,264,243,late,75,255,-1071,1,10
1000,165,27061,25871,asynch,20,258,222,late,75,242,-1190,1,10
1000,166,27222,25626,asynch,16,204,179,late,75,195,-1596,1,10
1000,167,27995,27813,asynch,15,315,289,late,75,304,-182,1,10
1000,168,27766,25824,asynch,13,228,206,late,75,219,-1942,1,10
1000,169,27125,25465,asynch,13,271,251,late,75,264,-1660,1,10
1000,170,26912,27134,asynch,9,164,149,late,75,158,222,1,10
1000,171,27962,26359,asynch,11,177,159,late,75,170,-1603,1,10
1000,172,26689,25158,asynch,10,192,176,late,75,186,-1531,1,10
1000,173,27249,26908,asynch,9,169,153,late,75,162,-341,1,10
1000,174,28373,27147,asynch,15,194,169,late,75,184,-1226,1,10
1000,175,27499,22984,asynch,4,364,357,late,90,361,-4515,1,11
1000,176,27893,24873,asynch,25,357,313,late,90,338,-3020,1,11
1000,177,26658,22070,asynch,31,378,325,late,90,356,-4588,1,11
1000,178,28203,24702,asynch,11,365,345,late,90,356,-3501,1,11
1000,179,28105,22329,asynch,12,351,335,late,90,347,-5776,1,11
1000,180,27557,22020,asynch,27,316,270,late,90,297,-5537,1,11
1000,181,27822,23486,asynch,18,399,371,late,90,389,-4336,1,11
1000,182,28164,21743,asynch,14,217,195,late,90,209,-6421,1,11
1000,183,28483,23675,asynch,16,229,202,late,90,218,-4808,1,11
1000,184,28508,22537,asynch,36,363,304,late,90,340,-5971,1,11
1000,185,27302,22454,asynch,26,287,238,late,90,264,-4848,1,11
1000,186,27003,23071,asynch,16,320,296,late,90,312,-3932,1,11
1000,187,27303,22286,asynch,15,273,246,late,90,261,-5017,1,11
1000,188,27075,22264,asynch,28,279,234,late,90,262,-4811,1,11
1000,189,27253,23099,asynch,27,352,309,late,90,336,-4154,1,11
1000,190,27213,24468,asynch,7,352,339,late,90,346,-2745,1,11
1000,191,28333,23338,asynch,20,331,296,late,90,316,-4995,1,11
1000,192,27807,24660,asynch,14,362,339,late,90,353,-3147,1,11
1000,193,26726,23800,asynch,8,392,378,late,90,386,-2926,1,11
1000,194,25850,21574,asynch,15,278,256,late,90,271,-4276,1,11
1000,195,28046,24162,asynch,9,255,241,late,90,250,-3884,1,11
1000,196,27955,22523,asynch,35,371,310,late,90,345,-5432,1,11
1000,197,28309,23264,asynch,18,351,324,late,90,342,-5045,1,11
1000,198,27393,24441,asynch,7,264,254,late,90,261,-2952,1,11
1000,199,26819,21300,asynch,12,307,284,late,90,296,-5519,1,11
1000,0,18921,20037,synch,0,919,919,control,0,919,1116,1,12
1000,1,19555,19551,synch,0,940,940,control,0,940,-4,1,12
1000,2,19236,19951,synch,0,958,958,control,0,958,715,1,12
1000,3,19425,19348,synch,0,898,898,control,0,898,-77,1,12
1000,4,19553,19783,synch,0,942,942,control,0,942,230,1,12
1000,5,20371,18609,synch,0,892,892,control,0,892,-1762,1,12
1000,6,19425,19468,synch,0,923,923,control,0,923,43,1,12
1000,7,20120,19384,synch,0,956,956,control,0,956,-736,1,12
1000,8,19259,20916,synch,0,950,950,control,0,950,1657,1,12
1000,9,17913,19404,synch,0,945,945,control,0,945,1491,1,12
1000,10,17262,20161,synch,0,975,975,control,0,975,2899,1,12
1000,11,18859,18313,synch,0,941,941,control,0,941,-546,1,12
1000,12,18564,20287,synch,0,946,946,control,0,946,1723,1,12
1000,13,20917,20013,synch,0,938,938,control,0,938,-904,1,12
1000,14,18986,19362,synch,0,960,960,control,0,960,376,1,12
1000,15,17957,19048,synch,0,923,923,control,0,923,1091,1,12
1000,16,20539,20750,synch,0,983,983,control,0,983,211,1,12
1000,17,19784,19931,synch,0,916,916,control,0,916,147,1,12
1000,18,19616,20057,synch,0,1024,1024,control,0,1024,441,1,12
1000,19,18106,19930,synch,0,1002,1002,control,0,1002,1824,1,12
1000,20,20352,20118,synch,0,947,947,control,0,947,-234,1,12
1000,21,20937,19530,synch,0,933,933,control,0,933,-1407,1,12
1000,22,19153,19992,synch,0,933,933,control,0,933,839,1,12
1000,23,18948,20143,synch,0,926,926,control,0,926,1195,1,12
1000,24,17536,20118,synch,0,949,949,control,0,949,2582,1,12
1000,525,19803,16696,synch,0,891,891,early,10,891,-3107,1,13
1000,526,21126,17704,synch,0,879,879,early,10,879,-3422,1,13
1000,527,19260,17767,synch,0,780,780,early,10,780,-1493,1,13
1000,528,20098,18609,synch,0,833,833,early,10,833,-1489,1,13
1000,529,18250,18166,synch,0,835,835,early,10,835,-84,1,13
1000,530,19405,18942,synch,0,835,835,early,10,835,-463,1,13
1000,531,19909,18860,synch,0,810,810,early,10,810,-1049,1,13
1000,532,19428,17641,synch,0,841,841,early,10,841,-1787,1,13
1000,533,19092,17746,synch,0,835,835,early,10,835,-1346,1,13
1000,534,19783,18060,synch,0,836,836,early,10,836,-1723,1,13
1000,535,19678,18543,synch,0,801,801,early,10,801,-1135,1,13
1000,536,19719,16800,synch,0,882,882,early,10,882,-2919,1,13
1000,537,19636,16948,synch,0,855,855,early,10,855,-2688,1,13
1000,538,20286,17893,synch,0,799,799,early,10,799,-2393,1,13
1000,539,20601,17641,synch,0,849,849,early,10,849,-2960,1,13
1000,540,19930,18942,synch,0,842,842,early,10,842,-988,1,13
1000,541,19888,18333,synch,0,838,838,early,10,838,-1555,1,13
1000,542,20183,17367,synch,0,821,821,early,10,821,-2816,1,13
1000,543,19070,18081,synch,0,788,788,early,10,788,-989,1,13
1000,544,20224,16401,synch,0,905,905,early,10,905,-3823,1,13
1000,545,18250,17934,synch,0,874,874,early,10,874,-316,1,13
1000,546,19005,18396,synch,0,829,829,early,10,829,-609,1,13
1000,547,17703,18208,synch,0,877,877,early,10,877,505,1,13
1000,548,20244,15351,synch,0,805,805,early,10,805,-4893,1,13
1000,549,19951,17201,synch,0,889,889,early,10,889,-2750,1,13
1000,550,19217,12747,synch,0,476,476,early,25,476,-6470,1,14
1000,551,20265,13756,synch,0,595,595,early,25,595,-6509,1,14
1000,552,20035,12558,synch,0,498,498,early,25,498,-7477,1,14
1000,553,19322,12852,synch,0,503,503,early,25,503,-6470,1,14
1000,554,19510,12958,synch,0,605,605,early,25,605,-6552,1,14
1000,555,19363,12875,synch,0,585,585,early,25,585,-6488,1,14
1000,556,19635,12895,synch,0,676,676,early,25,676,-6740,1,14
1000,557,20035,12348,synch,0,538,538,early,25,538,-7687,1,14
1000,558,20771,11655,synch,0,516,516,early,25,516,-9116,1,14
1000,559,20034,12369,synch,0,637,637,early,25,637,-7665,1,14
1000,560,19993,11886,synch,0,499,499,early,25,499,-8107,1,14
1000,561,19951,10815,synch,0,561,561,early,25,561,-9136,1,14
1000,562,19826,11866,synch,0,586,586,early,25,586,-7960,1,14
1000,563,20202,12411,synch,0,672,672,early,25,672,-7791,1,14
1000,564,19324,11256,synch,0,541,541,early,25,541,-8068,1,14
1000,565,19741,11298,synch,0,532,532,early,25,532,-8443,1,14
1000,566,18123,13587,synch,0,582,582,early,25,582,-4536,1,14
1000,567,19154,13461,synch,0,602,602,early,25,602,-5693,1,14
1000,568,19783,11277,synch,0,523,523,early,25,523,-8506,1,14
1000,569,20666,12411,synch,0,642,642,early,25,642,-8255,1,14
1000,570,19908,11907,synch,0,534,534,early,25,534,-8001,1,14
1000,571,19972,11004,synch,0,493,493,early,25,493,-8968,1,14
1000,572,19973,11781,synch,0,530,530,early,25,530,-8192,1,14
1000,573,19362,14574,synch,0,654,654,early,25,654,-4788,1,14
1000,574,17557,13188,synch,0,598,598,early,25,598,-4369,1,14
1000,575,19658,10374,synch,0,459,459,early,50,459,-9284,1,15
1000,576,19656,9954,synch,0,463,463,early,50,463,-9702,1,15
1000,577,20245,9765,synch,0,482,482,early,50,482,-10480,1,15
1000,578,19637,9618,synch,0,479,479,early,50,479,-10019,1,15
1000,579,19826,10416,synch,0,464,464,early,50,464,-9410,1,15
1000,580,19615,9387,synch,0,449,449,early,50,449,-10228,1,15
1000,581,19278,10311,synch,0,498,498,early,50,498,-8967,1,15
1000,582,19594,10080,synch,0,494,494,early,50,494,-9514,1,15
1000,583,20020,10206,synch,0,435,435,early,50,435,-9814,1,15
1000,584,19573,9660,synch,0,465,465,early,50,465,-9913,1,15
1000,585,19425,10732,synch,0,467,467,early,50,467,-8693,1,15
1000,586,18606,10143,synch,0,464,464,early,50,464,-8463,1,15
1000,587,20895,9870,synch,0,503,503,early,50,503,-11025,1,15
1000,588,18858,10059,synch,0,497,497,early,50,497,-8799,1,15
1000,589,19594,9702,synch,0,463,463,early,50,463,-9892,1,15
1000,590,18018,10227,synch,0,519,519,early,50,519,-7791,1,15
1000,591,19846,10060,synch,0,446,446,early,50,446,-9786,1,15
1000,592,19425,9681,synch,0,454,454,early,50,454,-9744,1,15
1000,593,17913,9954,synch,0,475,475,early,50,475,-7959,1,15
1000,594,18732,9892,synch,0,457,457,early,50,457,-8840,1,15
1000,595,19573,9849,synch,0,489,489,early,50,489,-9724,1,15
1000,596,19972,10983,synch,0,509,509,early,50,509,-8989,1,15
1000,597,19342,9388,synch,0,460,460,early,50,460,-9954,1,15
1000,598,20013,9177,synch,0,474,474,early,50,474,-10836,1,15
1000,599,19846,10689,synch,0,494,494,early,50,494,-9157,1,15
1000,600,19887,693,synch,0,14,14,early,75,14,-19194,1,16
1000,601,19868,945,synch,0,26,26,early,75,26,-18923,1,16
1000,602,19551,798,synch,0,14,14,early,75,14,-18753,1,16
1000,603,19488,1638,synch,0,24,24,early,75,24,-17850,1,16
1000,604,20013,1281,synch,0,15,15,early,75,15,-18732,1,16
1000,605,20202,987,synch,0,26,26,early,75,26,-19215,1,16
1000,606,20098,903,synch,0,26,26,early,75,26,-19195,1,16
1000,607,19068,1197,synch,0,27,27,early,75,27,-17871,1,16
1000,608,20496,1260,synch,0,36,36,early,75,36,-19236,1,16
1000,609,20225,1197,synch,0,29,29,early,75,29,-19028,1,16
1000,610,19404,798,synch,0,14,14,early,75,14,-18606,1,16
1000,611,20415,945,synch,0,15,15,early,75,15,-19470,1,16
1000,612,18106,945,synch,0,11,11,early,75,11,-17161,1,16
1000,613,20541,903,synch,0,20,20,early,75,20,-19638,1,16
1000,614,19509,1113,synch,0,33,33,early,75,33,-18396,1,16
1000,615,20308,735,synch,0,34,34,early,75,34,-19573,1,16
1000,616,18966,1428,synch,0,27,27,early,75,27,-17538,1,16
1000,617,19028,924,synch,0,10,10,early,75,10,-18104,1,16
1000,618,20056,1092,synch,0,13,13,early,75,13,-18964,1,16
1000,619,18775,1260,synch,0,43,43,early,75,43,-17515,1,16
1000,620,19175,1407,synch,0,43,43,early,75,43,-17768,1,16
1000,621,20748,1071,synch,0,25,25,early,75,25,-19677,1,16
1000,622,20097,1239,synch,0,30,30,early,75,30,-18858,1,16
1000,623,19342,861,synch,0,22,22,early,75,22,-18481,1,16
1000,624,18900,1197,synch,0,28,28,early,75,28,-17703,1,16
630,626,19070,0,synch,0,0,0,early,90,0,-19070,0,17
700,629,20202,0,synch,0,0,0,early,90,0,-20202,0,17
700,631,20267,0,synch,0,0,0,early,90,0,-20267,0,17
700,634,18753,0,synch,0,0,0,early,90,0,-18753,0,17
700,641,18901,0,synch,0,0,0,early,90,0,-18901,0,17
700,642,20186,0,synch,0,0,0,early,90,0,-20186,0,17
700,643,19427,0,synch,0,0,0,early,90,0,-19427,0,17
700,647,20394,0,synch,0,0,0,early,90,0,-20394,0,17
770,627,19616,21,synch,0,0,0,early,90,0,-19595,0,17
770,630,19699,63,synch,0,0,0,early,90,0,-19636,0,17
770,632,18334,21,synch,0,0,0,early,90,0,-18313,0,17
770,644,19154,42,synch,0,0,0,early,90,0,-19112,0,17
770,649,20160,84,synch,0,0,0,early,90,0,-20076,0,17
840,625,18691,105,synch,0,0,0,early,90,0,-18586,0,17
840,628,20307,42,synch,0,0,0,early,90,0,-20265,0,17
840,636,19532,42,synch,0,0,0,early,90,0,-19490,0,17
840,637,19950,42,synch,0,0,0,early,90,0,-19908,0,17
840,638,19509,105,synch,0,0,0,early,90,0,-19404,0,17
840,639,19741,21,synch,0,0,0,early,90,0,-19720,0,17
840,640,19887,21,synch,0,0,0,early,90,0,-19866,0,17
840,645,20161,21,synch,0,0,0,early,90,0,-20140,0,17
910,633,19572,42,synch,0,0,0,early,90,0,-19530,0,17
910,635,18901,42,synch,0,0,0,early,90,0,-18859,0,17
910,646,19866,84,synch,0,0,0,early,90,0,-19782,0,17
910,648,19804,63,synch,0,0,0,early,90,0,-19741,0,17
1000,225,19467,18459,synch,0,915,915,late,10,915,-1008,1,18
1000,226,19803,18607,synch,0,955,955,late,10,955,-1196,1,18
1000,227,18985,19343,synch,0,896,896,late,10,896,358,1,18
1000,228,20079,18965,synch,0,891,891,late,10,891,-1114,1,18
1000,229,19216,18669,synch,0,876,876,late,10,876,-547,1,18
1000,230,18502,18228,synch,0,973,973,late,10,973,-274,1,18
1000,231,19091,18715,synch,0,915,915,late,10,915,-376,1,18
1000,232,19910,19049,synch,0,865,865,late,10,865,-861,1,18
1000,233,20792,19091,synch,0,878,878,late,10,878,-1701,1,18
1000,234,19866,19279,synch,0,936,936,late,10,936,-587,1,18
1000,235,20391,18691,synch,0,872,872,late,10,872,-1700,1,18
1000,236,19824,19238,synch,0,883,883,late,10,883,-586,1,18
1000,237,19531,18606,synch,0,875,875,late,10,875,-925,1,18
1000,238,20140,18524,synch,0,901,901,late,10,901,-1616,1,18
1000,239,20034,19742,synch,0,875,875,late,10,875,-292,1,18
1000,240,19362,18860,synch,0,841,841,late,10,841,-502,1,18
1000,241,19784,18376,synch,0,879,879,late,10,879,-1408,1,18
1000,242,20477,19216,synch,0,943,943,late,10,943,-1261,1,18
1000,243,19404,18354,synch,0,905,905,late,10,905,-1050,1,18
1000,244,20351,19406,synch,0,920,920,late,10,920,-945,1,18
1000,245,19322,19131,synch,0,886,886,late,10,886,-191,1,18
1000,246,19740,20685,synch,0,868,868,late,10,868,945,1,18
1000,247,19614,19763,synch,0,922,922,late,10,922,149,1,18
1000,248,20539,18586,synch,0,923,923,late,10,923,-1953,1,18
1000,249,19425,19005,synch,0,881,881,late,10,881,-420,1,18
1000,250,19971,17851,synch,0,869,869,late,25,869,-2120,1,19
1000,251,19300,17787,synch,0,842,842,late,25,842,-1513,1,19
1000,252,19742,17934,synch,0,872,872,late,25,872,-1808,1,19
1000,253,19551,18081,synch,0,792,792,late,25,792,-1470,1,19
1000,254,19321,17956,synch,0,857,857,late,25,857,-1365,1,19
1000,255,18942,17913,synch,0,842,842,late,25,842,-1029,1,19
1000,256,20602,17619,synch,0,814,814,late,25,814,-2983,1,19
1000,257,20204,18082,synch,0,845,845,late,25,845,-2122,1,19
1000,258,19341,16863,synch,0,837,837,late,25,837,-2478,1,19
1000,259,18650,17684,synch,0,800,800,late,25,800,-966,1,19
1000,260,19174,17262,synch,0,839,839,late,25,839,-1912,1,19
1000,261,19509,16863,synch,0,829,829,late,25,829,-2646,1,19
1000,262,20517,17724,synch,0,840,840,late,25,840,-2793,1,19
1000,263,19322,17683,synch,0,843,843,late,25,843,-1639,1,19
1000,264,19973,18123,synch,0,854,854,late,25,854,-1850,1,19
1000,265,18902,16359,synch,0,853,853,late,25,853,-2543,1,19
1000,266,20475,17179,synch,0,849,849,late,25,849,-3296,1,19
1000,267,19721,16297,synch,0,816,816,late,25,816,-3424,1,19
1000,268,18900,17641,synch,0,810,810,late,25,810,-1259,1,19
1000,269,19950,17283,synch,0,834,834,late,25,834,-2667,1,19
1000,270,18882,17661,synch,0,838,838,late,25,838,-1221,1,19
1000,271,19196,17388,synch,0,824,824,late,25,824,-1808,1,19
1000,272,20204,18124,synch,0,848,848,late,25,848,-2080,1,19
1000,273,20250,17118,synch,0,816,816,late,25,816,-3132,1,19
1000,274,19236,16927,synch,0,811,811,late,25,811,-2309,1,19
1000,275,18333,14049,synch,0,626,626,late,50,626,-4284,1,20
1000,276,19028,14910,synch,0,701,701,late,50,701,-4118,1,20
1000,277,18796,13461,synch,0,673,673,late,50,673,-5335,1,20
1000,278,19155,15603,synch,0,656,656,late,50,656,-3552,1,20
1000,279,20183,14847,synch,0,688,688,late,50,688,-5336,1,20
1000,280,19678,15393,synch,0,684,684,late,50,684,-4285,1,20
1000,281,20013,14785,synch,0,692,692,late,50,692,-5228,1,20
1000,282,19847,14049,synch,0,599,599,late,50,599,-5798,1,20
1000,283,19616,14994,synch,0,644,644,late,50,644,-4622,1,20
1000,284,20286,14890,synch,0,656,656,late,50,656,-5396,1,20
1000,285,19637,15519,synch,0,690,690,late,50,690,-4118,1,20
1000,286,19427,14260,synch,0,643,643,late,50,643,-5167,1,20
1000,287,20580,14511,synch,0,635,635,late,50,635,-6069,1,20
1000,288,19047,15708,synch,0,741,741,late,50,741,-3339,1,20
1000,289,19111,13965,synch,0,623,623,late,50,623,-5146,1,20
1000,290,19615,14196,synch,0,749,749,late,50,749,-5419,1,20
1000,291,18544,14469,synch,0,635,635,late,50,635,-4075,1,20
1000,292,18502,13988,synch,0,678,678,late,50,678,-4514,1,20
1000,293,18502,13734,synch,0,603,603,late,50,603,-4768,1,20
1000,294,18403,13820,synch,0,594,594,late,50,594,-4583,1,20
1000,295,19846,14616,synch,0,690,690,late,50,690,-5230,1,20
1000,296,19302,14070,synch,0,623,623,late,50,623,-5232,1,20
1000,297,20391,15246,synch,0,780,780,late,50,780,-5145,1,20
1000,298,19386,12684,synch,0,558,558,late,50,558,-6702,1,20
1000,299,19194,13692,synch,0,689,689,late,50,689,-5502,1,20
1000,300,18460,10920,synch,0,377,377,late,75,377,-7540,1,21
1000,301,19405,11445,synch,0,516,516,late,75,516,-7960,1,21
1000,302,18335,11151,synch,0,581,581,late,75,581,-7184,1,21
1000,303,19321,11216,synch,0,452,452,late,75,452,-8105,1,21
1000,304,19994,12663,synch,0,503,503,late,75,503,-7331,1,21
1000,305,18753,11235,synch,0,583,583,late,75,583,-7518,1,21
1000,306,18963,10416,synch,0,464,464,late,75,464,-8547,1,21
1000,307,21066,12621,synch,0,560,560,late,75,560,-8445,1,21
1000,308,20518,12664,synch,0,549,549,late,75,549,-7854,1,21
1000,309,20727,13440,synch,0,511,511,late,75,511,-7287,1,21
1000,310,17997,8779,synch,0,443,443,late,75,443,-9218,1,21
1000,311,18985,10857,synch,0,440,440,late,75,440,-8128,1,21
1000,312,20415,12495,synch,0,537,537,late,75,537,-7920,1,21
1000,313,18921,11152,synch,0,459,459,late,75,459,-7769,1,21
1000,314,19196,10458,synch,0,446,446,late,75,446,-8738,1,21
1000,315,19762,11676,synch,0,586,586,late,75,586,-8086,1,21
1000,316,18858,12138,synch,0,581,581,late,75,581,-6720,1,21
1000,317,19866,11382,synch,0,592,592,late,75,592,-8484,1,21
1000,318,18186,11382,synch,0,488,488,late,75,488,-6804,1,21
1000,319,18483,10500,synch,0,494,494,late,75,494,-7983,1,21
1000,320,20161,10290,synch,0,554,554,late,75,554,-9871,1,21
1000,321,20266,11109,synch,0,446,446,late,75,446,-9157,1,21
1000,322,18922,9996,synch,0,474,474,late,75,474,-8926,1,21
1000,323,17726,9513,synch,0,492,492,late,75,492,-8213,1,21
1000,324,17913,10290,synch,0,482,482,late,75,482,-7623,1,21
1000,325,19951,9114,synch,0,445,445,late,90,445,-10837,1,22
1000,326,20416,10858,synch,0,540,540,late,90,540,-9558,1,22
1000,327,18986,9597,synch,0,525,525,late,90,525,-9389,1,22
1000,328,18590,6427,synch,0,313,313,late,90,313,-12163,1,22
1000,329,19638,10795,synch,0,540,540,late,90,540,-8843,1,22
1000,330,19824,11235,synch,0,581,581,late,90,581,-8589,1,22
1000,331,18397,6657,synch,0,274,274,late,90,274,-11740,1,22
1000,332,19468,8066,synch,0,416,416,late,90,416,-11402,1,22
1000,333,19824,11088,synch,0,528,528,late,90,528,-8736,1,22
1000,334,20751,10227,synch,0,577,577,late,90,577,-10524,1,22
1000,335,18965,12370,synch,0,562,562,late,90,562,-6595,1,22
1000,336,20181,11781,synch,0,545,545,late,90,545,-8400,1,22
1000,337,19300,8148,synch,0,397,397,late,90,397,-11152,1,22
1000,338,19362,10143,synch,0,547,547,late,90,547,-9219,1,22
1000,339,19803,12117,synch,0,551,551,late,90,551,-7686,1,22
1000,340,20057,11970,synch,0,568,568,late,90,568,-8087,1,22
1000,341,19677,11151,synch,0,574,574,late,90,574,-8526,1,22
1000,342,19635,10038,synch,0,597,597,late,90,597,-9597,1,22
1000,343,20769,11025,synch,0,537,537,late,90,537,-9744,1,22
1000,344,20119,12243,synch,0,549,549,late,90,549,-7876,1,22
1000,345,19467,8505,synch,0,436,436,late,90,436,-10962,1,22
1000,346,19616,10374,synch,0,533,533,late,90,533,-9242,1,22
1000,347,20183,10584,synch,0,462,462,late,90,462,-9599,1,22
1000,348,19488,8631,synch,0,298,298,late,90,298,-10857,1,22
1000,349,19383,7477,synch,0,321,321,late,90,321,-11906,1,22
